Wakey Wakey! Eggs and Bacy!
An Interactive Fiction by Brian Todoroff
Release 1 / Serial number 171017 / Inform 7 build 6M62 (I6/v6.33 lib 6/12N) SD
You crawl out of bed to Taylor Swift's new song.  It's another Tuesday morning and you smell waffles calling to you from downstairs.

Lauren's Room
There as sooooo many things tucked into every nook and crany of this room.  Arts and crafts and projects cover the shelves and the bed is a rumpled pile of blankets and pillows.

The closet door, complete with an array of fasionable footwear, is open to the north.

A door wearing a moustach and glasses is to the northwest.

>look
Upstairs Hall

>?
That's not a verb I recognise.

>go northeast
You can't go that way.

>go northwest
You can't go that way.

>go north
You can't go that way.

>goto Upstairs Hall
That's not a verb I recognise.

* * *

>look
Upstairs Hall

>go southeast
Laurens's Room

>look
Laurens's Room

>look around
You can't see any such thing.

>look
Laurens's Room

* * *

>go southwest
Caitlins's Room

>go northeast
Upstairs Hall

>go southeast
Laurens's Room

>go northwest
Upstairs Hall

>go northeast
Girl's Bathroom

>go down
You can't go that way.

>go southwest
Upstairs Hall

>go down
Downstairs

>go up
Upstairs Hall

* * *

>look around
You can't see any such thing.

>look
Upstairs Hall

* * *

>look
Laurens's Room

>open Closet Door
You can't see any such thing.

>look
Laurens's Room

>go north
You can't go that way.

* * *

>Go southeast
LRoom

>look
Laurens's Room

* * *

>go southeast
Lauren's Room
There as sooooo many things tucked into every nook and crany of this room.

A door wearing a moustach and glasses is to the northwest.

The closet door, complete with an array of fasionable footwear, is open to the north.

>go northwest
Upstairs Hall

* * *

>go southeast
Lauren's Room
There as sooooo many things tucked into every nook and crany of this room.

A door wearing a moustach and glasses is to the northwest.

The closet door, complete with an array of fasionable footwear, is open to the north.

>go north
Lauren's Closet
Obviously a fasionista has stocked this closet!

The closet door, complete with an array of fasionable footwear, is open to the south.

A colorful dirty clothes basket sits in the middle of the closet and a few clothes have actually made it in!

>look
Lauren's Closet
Obviously a fasionista has stocked this closet!

The closet door is complete with an array of fasionable footwear.

A colorful dirty clothes basket sits in the middle of the closet and a few clothes have actually made it in!

>close closet door
You close the Closet Door.

>look
Lauren's Closet
Obviously a fasionista has stocked this closet!

The closet door is complete with an array of fasionable footwear.

A colorful dirty clothes basket sits in the middle of the closet and a few clothes have actually made it in!

* * *

>go north
Lauren's Closet
Obviously a fasionista has stocked this closet!

The closet door, complete with an array of fasionable footwear, is open to the south.

A colorful dirty clothes basket sits in the middle of the closet and a few clothes have actually made it in!

>close door
You close the Closet Door.

>look
Lauren's Closet
Obviously a fasionista has stocked this closet!

The closet door, complete with an array of fasionable footwear, is closed to the south.

A colorful dirty clothes basket sits in the middle of the closet and a few clothes have actually made it in!

>go south
(first opening the Closet Door)

Lauren's Room
There as sooooo many things tucked into every nook and crany of this room.

The closet door, complete with an array of fasionable footwear, is open to the north.

A door wearing a moustach and glasses is to the northwest.

>close door
Which do you mean, the Closet Door or Lauren's Door?

>look
Lauren's Room
There as sooooo many things tucked into every nook and crany of this room.

The closet door, complete with an array of fasionable footwear, is open to the north.

A door wearing a moustach and glasses is to the northwest.

>go north
Lauren's Closet
Obviously a fasionista has stocked this closet!

The closet door, complete with an array of fasionable footwear, is open to the south.

A colorful dirty clothes basket sits in the middle of the closet and a few clothes have actually made it in!

>go south
Lauren's Room
There as sooooo many things tucked into every nook and crany of this room.

The closet door, complete with an array of fasionable footwear, is open to the north.

A door wearing a moustach and glasses is to the northwest.

>go northwest
Upstairs Hall
A door wearing a moustach and glasses is to the southeast.

* * *

>get into Lauren's Bed
That's not something you can enter.

* * *

>get into Lauren's bed
You get onto Lauren's Bed.

>look
Lauren's Room (on Lauren's Bed)
There as sooooo many things tucked into every nook and crany of this room.  Arts and crafts and projects cover the shelves and the bed is a rumpled pile of blankets and pillows.

The closet door, complete with an array of fasionable footwear, is open to the south.

A door wearing a moustach and glasses is to the southeast.

>get out
You get off Lauren's Bed.

Lauren's Room
There as sooooo many things tucked into every nook and crany of this room.  Arts and crafts and projects cover the shelves and the bed is a rumpled pile of blankets and pillows.

The closet door, complete with an array of fasionable footwear, is open to the north.

A door wearing a moustach and glasses is to the northwest.

>look under Lauren's Bed
Maybe you better not...

>look at Lauren's bed
Warm and cozy, the bed calls to you.

>look at Lauren's Door
You see nothing special about Lauren's Door.

>look at the door
Which do you mean, the Closet Door or Lauren's Door?

>go to Hall
You can't see any such thing.

>go northwest
Upstairs Hall
A door wearing a moustach and glasses is to the southeast.

A open white door is to the southwest.

>go southwest
Caitlin's Room
This is a very cute room with purple walls and a zoo's worth of stuffed animals.  The bed looks a bit like a fluffy tornado has been through.

A open white door is to the northeast.

* * *

>go northwest
Upstairs Hall
A door wearing a moustach and glasses is to the southeast.

The stairs lead downstairs to breakfast once you are ready for the day.

The bathroom door is open to the northeast.

A open white door is to the southwest.

>go northeast
Girl's Bathroom
A small bathroom complete with calming blue walls, a single granite sink, toilet, and shower with tub.

The bathroom door is open to the south.

>get into shower
You get into Shower.

>look
Girl's Bathroom (in Shower)
A small bathroom complete with calming blue walls, a single granite sink, toilet, and shower with tub.

The bathroom door is open to the northeast.

You can also see a Bathroom Toilet here.

>look at shower
A tub with shower and glass doors is surrounded with white marble walls with streaks of blue that remind you of the waves at the beach.

>get out of shower
I only understood you as far as wanting to get outside.

>get out
You get out of Shower.

Girl's Bathroom
A small bathroom complete with calming blue walls, a single granite sink, toilet, and shower with tub.

The bathroom door is open to the south.

You can also see a Bathroom Toilet here.

>flush john
You can't see any such thing.

* * *

>go northeast
Girl's Bathroom
A small bathroom complete with calming blue walls, a single granite sink, toilet, and shower with tub.

The bathroom door is open to the south.

>flush john
The toilet flushes dramatically.

* * *

>go northwest
Upstairs Hall
A door wearing a moustach and glasses is to the southeast.

The stairs lead downstairs to breakfast once you are ready for the day.

The bathroom door is open to the northeast.

A open white door is to the southwest.

>go down
Just as you take the first step down, Mom's voice rings out "Not with that hair!"

>look
Upstairs Hall
A door wearing a moustach and glasses is to the southeast.

The stairs lead downstairs to breakfast once you are ready for the day.

The bathroom door is open to the northeast.

A open white door is to the southwest.

>go southeast
Lauren's Room
There as sooooo many things tucked into every nook and crany of this room.  Arts and crafts and projects cover the shelves and the bed is a rumpled pile of blankets and pillows.

A door wearing a moustach and glasses is to the northwest.

The closet door, complete with an array of fasionable footwear, is open to the north.

>look under bed
Under Lauren's Bed are Hair Brush, Left Shoe and Big Dust Bunny.

>take brush
Taken.

>brush hair
Fabulous! Just fabulous!

>go northwest
Upstairs Hall
A door wearing a moustach and glasses is to the southeast.

The stairs lead downstairs to breakfast once you are ready for the day.

The bathroom door is open to the northeast.

A open white door is to the southwest.

>go down
*** Mom looks you up and down and says "You did a great job getting ready today! Grab a waffle and let's get in the car!" ***

Would you like to RESTART, RESTORE a saved game, QUIT or UNDO the last command?

* * *

>look under bed
Under Lauren's Bed are a hairbrush, a left shoe and a big dust bunny.

>take hair brush
Taken.

>inventory
You are carrying:
  Hair Brush

>take sneaker
Taken.

>inventory
You are carrying:
  Left Shoe
  Hair Brush

>look at left shoe
You see nothing special about Left Shoe.

>look at shoe
You see nothing special about Left Shoe.

* * *

>take hair brush
Taken.

>go northwest
Upstairs Hall
A door wearing a moustach and glasses is to the southeast.

The bathroom door is open to the northeast.

A open white door is to the southwest.

>go downstairs
You can't see any such thing.

>go down
Downstairs

>go up
Upstairs Hall
A door wearing a moustach and glasses is to the southeast.

The bathroom door is open to the northeast.

A open white door is to the southwest.

* * *

>look under bed
Under Lauren's Bed are a hairbrush, a left shoe and a big dust bunny.

>take brush
You can't see any such thing.

>go northwest
Upstairs Hall
A door wearing a moustach and glasses is to the southeast.

The stairs lead downstairs to breakfast once you are ready for the day.

The bathroom door is open to the northeast.

A open white door is to the southwest.

* * *

>go down
Just as you take the first step down, Mom's voice rings out "Not with that hair!"

>brush hair
You could try it with your fingers, but really, you need a brush.

>brush my hair
You could try it with your fingers, but really, you need a brush.

>brush Hair
You could try it with your fingers, but really, you need a brush.

>brush
What do you want to brush?

>look at hair
It is a bit of a wild sight!

>loot at teeth
That's not a verb I recognise.

>look at teeth
Whoa! That breath makes your own eyes water!!

* * *

>look under bed
Under Lauren's Bed are a hairbrush, a left shoe and a big dust bunny.

>take Hairbrush
Taken.

* * *

>brush hair
Fabulous! Just fabulous!

* * *

>go northwest
Upstairs Hall
A door wearing a moustach and glasses is to the southeast.

The stairs lead downstairs to breakfast once you are ready for the day.

The bathroom door is open to the northeast.

A open white door is to the southwest.

>go down
You start to head down, but then catch a wiff of your own breath and almost pass out.

>go northeast
Girl's Bathroom
A small bathroom complete with calming blue walls, a single granite sink, toilet, and shower with tub.

The bathroom door is open to the south.

You can also see a counter (on which is a toothbrush) here.

>take toothbrush
Taken.

>brush teeth
You scrub away.  Top, bottom, inside, outside, and even scrub your tounge.  Sooo much better!

>brush teeth
They are sure to dazzel your teacher, so there isn't much to improve.

>go south
Upstairs Hall
The bathroom door is open to the northeast.

A door wearing a moustach and glasses is to the southeast.

The stairs lead downstairs to breakfast once you are ready for the day.

A open white door is to the southwest.

>go down
You look down and think someone will probably notice you're wearing the same clothes as yesterday.

>go southeast
Lauren's Room
There as sooooo many things tucked into every nook and crany of this room.  Arts and crafts and projects cover the shelves and the bed is a rumpled pile of blankets and pillows.

A door wearing a moustach and glasses is to the northwest.

The closet door, complete with an array of fasionable footwear, is open to the north.

>go north
Lauren's Closet
Obviously a fasionista has stocked this closet!

The closet door, complete with an array of fasionable footwear, is open to the south.

A colorful dirty clothes basket sits in the middle of the closet and a few clothes have actually made it in!

You clean outfit is ready to go.

>put on outfit
(first taking the clean clothes)
You have a tough time getting the new outfit over yesterday's outfit and give up.

>put on outfit
You have a tough time getting the new outfit over yesterday's outfit and give up.

>take off yesterday's clothes
Yesterday's clothes fall to the floor.

>put on outfit
You put on the clean clothes.

>look
Lauren's Closet
Obviously a fasionista has stocked this closet!

The closet door, complete with an array of fasionable footwear, is open to the south.

A colorful dirty clothes basket sits in the middle of the closet and a few clothes have actually made it in!

You can also see yesterday's clothes here.

>inventory
You are carrying:
  a clean clothes (being worn)
  a toothbrush
  a hairbrush

>put yesterday's clothes in the clothes basket
(first taking yesterday's clothes)
You put yesterday's clothes into the Dirty Clothes Basket.

>put yesterday's clothes in the dirty clothes basket
(first taking yesterday's clothes)
You put yesterday's clothes into the Dirty Clothes Basket.

>take yesterday's clothes
Taken.

>drop yesterday's clothes
Dropped.

>go south
Lauren's Room
There as sooooo many things tucked into every nook and crany of this room.  Arts and crafts and projects cover the shelves and the bed is a rumpled pile of blankets and pillows.

The closet door, complete with an array of fasionable footwear, is open to the north.

A door wearing a moustach and glasses is to the northwest.

>go northwest
Upstairs Hall
A door wearing a moustach and glasses is to the southeast.

The bathroom door is open to the northeast.

The stairs lead downstairs to breakfast once you are ready for the day.

A open white door is to the southwest.

>go down
The toothbrush in your hand seems a bit of over kill for school.

>drop toothbrush
Dropped.

>go down
You rember leaving the toothbrush somewhere it shouldn't be.

>tok toothbrush
That's not a verb I recognise.

>take toothbrush
Taken.

>go northeast
Girl's Bathroom
A small bathroom complete with calming blue walls, a single granite sink, toilet, and shower with tub.

The bathroom door is open to the south.

You can also see a counter here.

>put toothbrush on counter
You put the toothbrush on the counter.

>go south
Upstairs Hall
The bathroom door is open to the northeast.

A door wearing a moustach and glasses is to the southeast.

The stairs lead downstairs to breakfast once you are ready for the day.

A open white door is to the southwest.

>go down
You should probably put the hairbrush away on the bathroom counter so it doesn't end up under the bed again.

>go north
You can't go that way.

>go northeast
Girl's Bathroom
A small bathroom complete with calming blue walls, a single granite sink, toilet, and shower with tub.

The bathroom door is open to the south.

You can also see a counter (on which is a toothbrush) here.

>put hairbrush on counter
You put the hairbrush on the counter.

>go south
Upstairs Hall
The bathroom door is open to the northeast.

A door wearing a moustach and glasses is to the southeast.

The stairs lead downstairs to breakfast once you are ready for the day.

A open white door is to the southwest.

>go down
*** Mom looks you up and down and says "You did a great job getting ready today! Grab a waffle and let's get in the car!" ***

Would you like to RESTART, RESTORE a saved game, QUIT or UNDO the last command?

* * *

>Look at hair
It is a bit of a wild sight!

>look at my hair
You see nothing special about Hair.

* * *

>brush hair
That's not a verb I recognise.

>brushing hair
That's not a verb I recognise.

>brush
That's not a verb I recognise.

>brush bed
That's not a verb I recognise.

>look at hair
It is a bit of a wild sight!

>Brush hair
That's not a verb I recognise.

* * *

>brush bed
You can't see any such thing.

>brush hair
You could try it with your fingers, but really, you need a brush.

>brush door
You can't see any such thing.

>look under bed
Under Lauren's Bed are Hair Brush, Left Shoe and Big Dust Bunny.

>brush shoe
You can't see any such thing.

>take brush
Taken.

>brush hair
There really isn't much point.

>brush Hair
There really isn't much point.

* * *

>take brush
You can't see any such thing.

>look under bed
Under Lauren's Bed are Hair Brush, Left Shoe and Big Dust Bunny.

* * *

>brush hair
Fabulous! Just fabulous!

>look at hair
(Hair Brush)
You see nothing special about Hair Brush.

>look at Hair
(Hair Brush)
You see nothing special about Hair Brush.

>look at my Hair
You see nothing special about Hair Brush.

>drop Hair Brush
Dropped.

>look at hair
(Hair Brush)
You see nothing special about Hair Brush.

>go north
Lauren's Closet
Obviously a fasionista has stocked this closet!

The closet door, complete with an array of fasionable footwear, is open to the south.

A colorful dirty clothes basket sits in the middle of the closet and a few clothes have actually made it in!

>look at hair
It is looking quite nice.

>go south
Lauren's Room
There as sooooo many things tucked into every nook and crany of this room.  Arts and crafts and projects cover the shelves and the bed is a rumpled pile of blankets and pillows.

The closet door, complete with an array of fasionable footwear, is open to the north.

A door wearing a moustach and glasses is to the northwest.

You can also see Hair Brush here.